7 5
5 4 0 4 4
7 1 0 4 6
6 1 0 4 6
5 4 0 2 7
1 4 4 0 6
1 0 4 0 6
4 2 5 0 6
